1111111111111111
1000000000101E11
1P10000000000001
1CC0000000000011
1111111111111111