1111111111111111111
1C00000000000001111
1001011111000001111
100100C000000001111
1001000000000001111
1000111111110000C01
1P011E0000000000001
1000010000000000001
1001111111100000001
1000000000000000111
1001000000000001111
1111111111111111111